20, 20
11111111111111111111
12000000000000001111
11111115111111100111
11111110111011110001
11000000111000001101
10511110111111100001
10111110000000111111
10100011111115110001
10050011000000110101
11111111511111110101
11150000000050000101
15001111111111111001
10111111111111115111
10000500011100500111
11111111011101110111
11111111511101115001
11150000000050001111
15001111511101111111
10000500011150000031
11111111111111111111