20, 20
11111111111111111111
12000000000000001111
11111110111111100111
11111110111011110001
11000000111000001101
10011110111111100001
10111110000000111111
10100011111110110001
10000011000000110101
11111111011111110101
11100000000000000101
10001111111111111001
10111111111111110111
10000000011100000111
11111111011101110111
11111111011101110001
11100000000000001111
10001111011101111111
10000000011100000031
11111111111111111111